TTTTTTTTTTTTTTTTTTTTTTTT
TAAAAAARAAAAATAAAAAAAAT
TAAAATAAAAAAAAATAAAAAAT
TAAAAAAAAAARAAAAAAAAAAT
TAAAATAAATAAAAAATAAAAAT
TAAAAARAAAAAAAAAAAAAAAT
TAAAATAAAAAAAAATAAAAAAT
TAAAAAAAARAAAAATAAATAAT
TAAAATAAAAAAAAATAAAAAAT
TAAAAAAAATAAARAAAAAAAAAT
TAAAAAAAAAAAAAAAATAAAA.
TTTTTTTTTTTTTTTTTTTTTTTT
